XZXXXXX
XXVXZXX
XXSXYVX
XXXXXXX
XXXVXXX
XZXXXXX
